#################B#
################# #
################ ##
#########        ##
####      #########
     ##############
A##################